NO IMG/Wolfenstein/bluestone.png
SO IMG/Wolfenstein/greystone.png
WE IMG/Wolfenstein/mossy.png
EA IMG/Wolfenstein/eagle.png

F 0,100,0
C 0,0,0

11111111111111111111111111111
100000001100000N0000000111111
11111111100000111000000011111
10010000000000000000011111111
11111111101100000111000011111
10000000001100000111011111111
11110111111111011111000001001
111101111111110101 1010100101
11000000110101011111000010001
10000000000000001100000010001
10000000000000000101010011101
11000001110101010101011000111
11110110000001011000110100011
11111111111111111111111111111
